1111111111111
10000P00000P1
10C0000000001
100000E000001
1111111111111