1111111111111
1000E000000P1
1000000000001
100000E000C01
1111111111111