1111111111111
10000000000C1
1000000000001
100000E000001
1111111111111