1111111111111
1000E000000P1
100000000000
100010E000C01
1111111111111