1111111111111111111111111111111111
1E0000110000000C00000C0001111C0001
10110101001000001010010001C00101C1
1010010010101010001000100111010111
1P00000000C1C0000000100000000000C1
1111111111111111111111111111111111