11111111111111111111111111111111111111
1P0000000000C1C00000000000000000000001
10111101111110101111111101111111111001
1000000100000010000000010000000C001001
10111101011110111111110101111111101001
1C000101010000100000000101000000101001
11110101010111101111110101011110101001
1000010001C000001000000100010000100001
10111111101111111011111111011110111101
1000000010000000001C000000010000100001
10111110111111111011111111111110101111
1000001000000000100C000000000000100001
11111010111111101111111111111110111001
10C010100000001C0000000000000010001001
10101011111110111111111111111010101C01
10100000000010000000000000001000101001
10111111111011111111111111101111101001
100000000C100000000000000C1000000C10E1
11111111111111111111111111111111111111
