11111111111111111111111111111111111111
1P000000000001000000000000000000000001
10111101111110101111111101111111111001
10000001000000100000000100000000001001
10111101011110111111110101111111101001
10000101010000100000000101000000101001
11110101010111101111110101011110101001
10000100010000001000000100010000100001
10111111101111111011111111011110111101
10000000100000000010000000010000100001
10111110111111111011111111111110101111
10000010000000001000000000000000100001
11111010111111101111111111111110111001
10001010000000100000000000000010001001
10101011111110111111111111111010101001
10100000000010000000000000001000101001
10111111111011111111111111101111101001
100000000010000000000000001000000010E1
10111111101111111111111110101111111001
100000000000000000C0000001000000000001
11111111111111111111111111111111111111