1111111111111111111111111111111111
1001000C000111111111111111111111C1
1000011111001111111000000111111101
1P0011E000000111000000110000000001
1000001110010000010110000000111101
1111111111111111111111111111111111
