11111111111111111111111111111111111111
1PCCCCCCCCCCC1CCCCCCCCCCCCCCCCCCCCCCC1
1C1111C111111C1C11111111C1111111111CC1
1CCCCCC1CCCCCC1CCCCCCCC1CCCCCCCCCC1CC1
1C1111C1C1111C11111111C1C11111111C1CC1
1CCCC1C1C1CCCC1CCCCCCCC1C1CCCCCC1C1CC1
1111C1C1C1C1111C111111C1C1C1111C1C1CC1
1CCCC1CCC1CCCCCC1CCCCCC1CCC1CCCC1CCCC1
1C1111111C1111111C11111111C1111C1111C1
1CCCCCCC1CCCCCCCCC1CCCCCCCC1CCCC1CCCC1
1C11111C111111111C1111111111111C1C1111
1CCCCC1CCCCCCCCC1CCCCCCCCCCCCCCC1CCCC1
11111C1C1111111C111111111111111C111CC1
1CCC1C1CCCCCCC1CCCCCCCCCCCCCCC1CCC1CC1
1C1C1C1111111C111111111111111C1C1C1CC1
1C1CCCCCCCCC1CCCCCCCCCCCCCCC1CCC1C1CC1
1C111111111C111111111111111C11111C1CC1
1CCCCCCCCC1CCCCCCCCCCCCCCC1CCCCCCC1CE1
11111111111111111111111111111111111111