1111111111111
10000000C0001
100C111110011
100110E00PC01
1111111111111