1111111111111
10010000C0001
100C111110011
100P110E00C01
1111111111111